##################################################
#                                                #
#           @                                    #
#                                                #
##############################      ##############
#                                                #
#                                                #
#                                                #
#######        ###################################
#                                                #
#                                                #
#                                                #
#########################         ################
#                                                #
#                                                #
#                                                #
#                                                #
#######        ###################################
#                                                #
#                                                #
#                                                #
#####################         ####################
#                                                #
#                                      $         #
#                                                #
##################################################